,서비스_업종,분기,상권,2018_분기당_매출_금액,2019_분기당_매출_금액,2020_분기당_매출_금액,2018~2019_증감액,2019~2020_증감액,2018~2019_증감율,2019~2020_증감율
0,가구,1,관광특구,164612528,83818931,65358805,-80793597,-18460126,-49.08107419,-22.02381464
1,가구,2,관광특구,91182170,31849831,91867272,-59332339,60017441,-65.07011075,188.4388052
2,가구,3,관광특구,72585550,108941425,101055416,36355875,-7886009,50.0869319,-7.238760646
3,가구,4,관광특구,110123421,25730309,64112350,-84393112,38382041,-76.63502571,149.1705405
4,가방,1,골목상권,101631313,87329154,48476233,-14302159,-38852921,-14.07259099,-44.49020656
5,가방,1,관광특구,1534776917,1032502556,994689476,-502274361,-37813080,-32.72621287,-3.662274711
6,가방,1,발달상권,944736266,530455312,492301984,-414280954,-38153328,-43.85149262,-7.192562151
7,가방,1,전통시장,94218755,256591807,336922508,162373052,80330701,172.3362318,31.30680669
8,가방,2,골목상권,166685996,61187108,36356005,-105498888,-24831103,-63.29199245,-40.58224651
9,가방,2,관광특구,1999698388,1337531572,639977217,-662166816,-697554355,-33.11333449,-52.15236557
10,가방,2,발달상권,1076029368,954221391,273202287,-121807977,-681019104,-11.32013499,-71.36908797
11,가방,2,전통시장,169200176,145631787,261769249,-23568389,116137462,-13.92929343,79.74733016
12,가방,3,골목상권,210546703,23508931,30277201,-187037772,6768270,-88.83433905,28.79020743
13,가방,3,관광특구,1952615231,1162576101,747432010,-790039130,-415144091,-40.46056373,-35.70898203
14,가방,3,발달상권,1005050092,963332122,294614417,-41717970,-668717705,-4.150834902,-69.41715009
15,가방,3,전통시장,84821234,64290473,242495064,-20530761,178204591,-24.20474218,277.186623
16,가방,4,골목상권,150200188,202157548,90350875,51957360,-111806673,34.59207388,-55.30670218
17,가방,4,관광특구,1767874370,1706594402,1105657888,-61279968,-600936514,-3.466307846,-35.21261486
18,가방,4,발달상권,818648716,1003498250,370997473,184849534,-632500777,22.57983557,-63.02958446
19,가방,4,전통시장,246357092,270584896,513287266,24227804,242702370,9.834425225,89.69546105
20,가전제품수리,1,관광특구,31763917,3970490,31726358,-27793427,27755868,-87.49999882,699.0539707
21,가전제품수리,2,관광특구,15976354,23715627,21086520,7739273,-2629107,48.44204754,-11.08596876
22,가전제품수리,3,관광특구,10646265,23179074,26092556,12532809,2913482,117.7202427,12.5694495
23,골프연습장,1,관광특구,50124280,41893442,47628666,-8230838,5735224,-16.42086031,13.69002814
24,골프연습장,2,관광특구,41386064,35989925,38948620,-5396139,2958695,-13.03854119,8.220897932
25,골프연습장,3,관광특구,49130812,42103356,30129819,-7027456,-11973537,-14.30356168,-28.43843849
26,골프연습장,4,관광특구,46861199,51038556,27201301,4177357,-23837255,8.914319499,-46.70440715
27,네일숍,1,관광특구,143625050,103188329,9368303,-40436721,-93820026,-28.15436513,-90.92116028
28,네일숍,1,발달상권,113647355,91274891,1250454,-22372464,-90024437,-19.68586422,-98.63001315
29,네일숍,2,관광특구,174739544,75737661,11240382,-99001883,-64497279,-56.65682806,-85.15879438
30,네일숍,2,발달상권,145453707,69461741,439242,-75991966,-69022499,-52.24477778,-99.36764902
31,네일숍,3,관광특구,178555997,74007807,3181850,-104548190,-70825957,-58.55204628,-95.70065628
32,네일숍,3,발달상권,149294637,61488928,787469,-87805709,-60701459,-58.81370608,-98.71933204
33,네일숍,4,관광특구,97658093,18510100,107859,-79147993,-18402241,-81.04601531,-99.4172965
34,네일숍,4,발달상권,88487042,2576093,1040726,-85910949,-1535367,-97.08873419,-59.60060448
35,노래방,1,관광특구,186984477,175283232,143981972,-11701245,-31301260,-6.257869737,-17.85753243
36,노래방,1,발달상권,253982576,254568042,178540899,585466,-76027143,0.230514238,-29.86515605
37,노래방,2,관광특구,208394477,177439073,56621913,-30955404,-120817160,-14.85423436,-68.08937736
38,노래방,2,발달상권,277769928,231725871,67365822,-46044057,-164360049,-16.57632895,-70.92865734
39,노래방,3,관광특구,213770611,203092271,40017447,-10678340,-163074824,-4.995232951,-80.29592815
40,노래방,3,발달상권,298719658,267284216,44817298,-31435442,-222466918,-10.52339247,-83.23234396
41,노래방,4,관광특구,224108475,181014633,43751591,-43093842,-137263042,-19.22901042,-75.82980432
42,노래방,4,발달상권,306778325,243790865,74199130,-62987460,-169591735,-20.53191339,-69.56443384
43,당구장,1,관광특구,23731337,15512456,17254502,-8218881,1742046,-34.63302974,11.22998189
44,당구장,1,발달상권,23731337,15512456,17254502,-8218881,1742046,-34.63302974,11.22998189
45,당구장,2,관광특구,20092497,9241426,10725671,-10851071,1484245,-54.00558726,16.06077893
46,당구장,2,발달상권,20092497,9241426,10725671,-10851071,1484245,-54.00558726,16.06077893
47,당구장,3,관광특구,19397217,11023857,4444181,-8373360,-6579676,-43.16784207,-59.68578874
48,당구장,3,발달상권,19397217,11023857,4444181,-8373360,-6579676,-43.16784207,-59.68578874
49,당구장,4,관광특구,18169157,12723991,5125293,-5445166,-7598698,-29.96928256,-59.71945438
50,당구장,4,발달상권,18169157,12723991,5125293,-5445166,-7598698,-29.96928256,-59.71945438
51,문구,1,관광특구,56567143,12506429,7313582,-44060714,-5192847,-77.89100114,-41.5214207
52,문구,1,발달상권,47276157,12506429,7313582,-34769728,-5192847,-73.54601179,-41.5214207
53,문구,2,관광특구,56517971,10088247,9702246,-46429724,-386001,-82.15037302,-3.82624454
54,문구,2,발달상권,45907153,10088247,9702246,-35818906,-386001,-78.02467297,-3.82624454
55,문구,3,관광특구,55816354,9952011,8728161,-45864343,-1223850,-82.17008047,-12.29751454
56,문구,3,발달상권,43000950,9952011,8728161,-33048939,-1223850,-76.85629969,-12.29751454
57,문구,4,관광특구,51763971,18717637,12860641,-33046334,-5856996,-63.84041518,-31.29132166
58,문구,4,발달상권,24506587,18717637,12860641,-5788950,-5856996,-23.6220164,-31.29132166
59,미용실,1,골목상권,344599352,375227861,180405915,30628509,-194821946,8.888150492,-51.92097023
60,미용실,1,관광특구,771656395,607552793,441466277,-164103602,-166086516,-21.26640861,-27.33696856
61,미용실,1,발달상권,216506418,152151893,87346070,-64354525,-64805823,-29.72407266,-42.592847
62,미용실,2,골목상권,354396313,317707816,170558837,-36688497,-147148979,-10.35239241,-46.31581963
63,미용실,2,관광특구,780493464,519360250,501395967,-261133214,-17964283,-33.45745045,-3.458925284
64,미용실,2,발달상권,229328702,130433026,80522778,-98895676,-49910248,-43.12398541,-38.26503879
65,미용실,3,골목상권,376311153,344735691,201055937,-31575462,-143679754,-8.39078559,-41.67823575
66,미용실,3,관광특구,775617304,542117257,460065897,-233500047,-82051360,-30.105059,-15.1353529
67,미용실,3,발달상권,221545096,125395548,73872177,-96149548,-51523371,-43.39953794,-41.08867645
68,미용실,4,골목상권,370394561,368206822,266386751,-2187739,-101820071,-0.590650952,-27.65295614
69,미용실,4,관광특구,716953053,497393242,424984437,-219559811,-72408805,-30.62401507,-14.55765758
70,미용실,4,발달상권,193954327,105816751,58911798,-88137576,-46904953,-45.44243862,-44.32658587
71,반찬가게,1,관광특구,58197594,201261398,555387783,143063804,354126385,245.8242586,175.9534558
72,반찬가게,1,발달상권,58197594,201261398,555387783,143063804,354126385,245.8242586,175.9534558
73,반찬가게,2,관광특구,96497596,352482164,559614188,255984568,207132024,265.2755909,58.76383124
74,반찬가게,2,발달상권,96488822,352482164,559614188,255993342,207132024,265.3088064,58.76383124
75,반찬가게,3,관광특구,60437589,373614188,642832099,313176599,269217911,518.1818206,72.05773219
76,반찬가게,3,발달상권,60437589,373614188,642832099,313176599,269217911,518.1818206,72.05773219
77,반찬가게,4,관광특구,187906003,544272339,665401101,356366336,121128762,189.6513844,22.25517509
78,반찬가게,4,발달상권,187906003,544272339,665401101,356366336,121128762,189.6513844,22.25517509
79,분식전문점,1,골목상권,282398197,598330419,507732051,315932222,-90598368,111.8747306,-15.14186228
80,분식전문점,1,관광특구,774474011,929140111,1269595756,154666100,340455645,19.97047,36.64201351
81,분식전문점,1,발달상권,171904590,170488309,163882771,-1416281,-6605538,-0.823876198,-3.874481505
82,분식전문점,1,전통시장,70948606,125438509,96754944,54489903,-28683565,76.80193604,-22.8666342
83,분식전문점,2,골목상권,321455803,540423181,246165027,218967378,-294258154,68.11741333,-54.44958032
84,분식전문점,2,관광특구,1003853077,849958953,671075082,-153894124,-178883871,-15.33034341,-21.04617763
85,분식전문점,2,발달상권,211169110,168482227,71475290,-42686883,-97006937,-20.2145489,-57.57695558
86,분식전문점,2,전통시장,167034058,143453133,68986831,-23580925,-74466302,-14.11743526,-51.9098471
87,분식전문점,3,골목상권,333543203,723694654,266564874,390151451,-457129780,116.9717888,-63.1661126
88,분식전문점,3,관광특구,953075605,1098169892,784631649,145094287,-313538243,15.22379612,-28.55097788
89,분식전문점,3,발달상권,197157963,151986339,102649496,-45171624,-49336843,-22.91138705,-32.46136681
90,분식전문점,3,전통시장,179340683,170149030,81639444,-9191653,-88509586,-5.125247014,-52.01886017
91,분식전문점,4,골목상권,577284609,690986065,236875945,113701456,-454110120,19.69590982,-65.71914298
92,분식전문점,4,관광특구,1201883090,1629458167,684440672,427575077,-945017495,35.57542997,-57.99581199
93,분식전문점,4,발달상권,192515471,293526768,95790564,101011297,-197736204,52.46918415,-67.36564619
94,분식전문점,4,전통시장,209764994,103586710,79052148,-106178284,-24534562,-50.61773272,-23.68504801
95,서적,1,골목상권,696818337,1024579956,1138445709,327761619,113865753,47.03688201,11.11340822
96,서적,1,관광특구,715902604,1029893163,1140956788,313990559,111063625,43.85939613,10.78399479
97,서적,1,발달상권,7097407,5313207,2511079,-1784200,-2802128,-25.13875842,-52.7389202
98,서적,2,골목상권,855486379,985447228,975611092,129960849,-9836136,15.19145742,-0.998139294
99,서적,2,관광특구,886747186,985447228,984237313,98700042,-1209915,11.1305729,-0.122778264
100,서적,3,골목상권,707739112,1008589045,1082626000,300849933,74036955,42.50859221,7.340646358
101,서적,3,관광특구,712318698,1013121992,1090589619,300803294,77467627,42.22875166,7.646426355
102,서적,3,발달상권,4579586,4532947,7963619,-46639,3430672,-1.018410835,75.68303799
103,서적,4,골목상권,2425406619,1188009948,1046939393,-1237396671,-141070555,-51.01811223,-11.87452641
104,서적,4,관광특구,2432027782,1192054921,1049013897,-1239972861,-143041024,-50.98514376,-11.99953303
105,서적,4,발달상권,6621163,4044973,2074504,-2576190,-1970469,-38.90842138,-48.71402108
106,섬유제품,1,관광특구,20575474,11367406,56415849,-9208068,45048443,-44.75264094,396.2948363
107,섬유제품,2,관광특구,30924312,39836848,38481775,8912536,-1355073,28.82048273,-3.40155677
108,섬유제품,3,관광특구,30935980,22592209,88694770,-8343771,66102561,-26.97108997,292.5900739
109,섬유제품,4,관광특구,21074001,56415848,89422250,35341847,33006402,167.7035462,58.50554972
110,세탁소,1,골목상권,31877297,19868655,18411036,-12008642,-1457619,-37.67145627,-7.336274146
111,세탁소,1,관광특구,39136526,101591471,116058557,62454945,14467086,159.5822404,14.24045332
112,세탁소,2,골목상권,32255209,20782959,20641453,-11472250,-141506,-35.56712344,-0.680875134
113,세탁소,2,관광특구,51813460,116247016,118523026,64433556,2276010,124.3567907,1.957908322
114,세탁소,3,골목상권,23234864,12406390,22918913,-10828474,10512523,-46.6044217,84.73474556
115,세탁소,3,관광특구,60621125,116174531,120204663,55553406,4030132,91.64034155,3.469032296
116,세탁소,4,골목상권,25810141,28910048,19378700,3099907,-9531348,12.01042257,-32.9689802
117,세탁소,4,관광특구,83492703,121726836,118856455,38234133,-2870381,45.79338269,-2.358051104
118,수산물판매,1,전통시장,2857500,877500,810000,-1980000,-67500,-69.29133858,-7.692307692
119,수산물판매,2,전통시장,1800000,900000,866250,-900000,-33750,-50,-3.75
120,슈퍼마켓,1,골목상권,189708944,65357357,99164385,-124351587,33807028,-65.54861588,51.72643074
121,슈퍼마켓,1,관광특구,7673285563,7469401242,4063995975,-203884321,-3405405267,-2.657066772,-45.59140896
122,슈퍼마켓,1,발달상권,7077107991,9413989685,4846890654,2336881694,-4567099031,33.02029158,-48.51395831
123,슈퍼마켓,2,골목상권,303292163,83069106,130546525,-220223057,47477419,-72.61086301,57.15412298
124,슈퍼마켓,2,관광특구,8314582791,6628999194,3767887397,-1685583597,-2861111797,-20.27261787,-43.16053922
125,슈퍼마켓,2,발달상권,7684988539,7942291589,4610211596,257303050,-3332079993,3.348125358,-41.95363461
126,슈퍼마켓,3,골목상권,322702850,92674148,191927052,-230028702,99252904,-71.28189354,107.0988039
127,슈퍼마켓,3,관광특구,8272342646,8265807297,5315086443,-6535349,-2950720854,-0.079002397,-35.69791489
128,슈퍼마켓,3,발달상권,7401604253,9066704771,6154316364,1665100518,-2912388407,22.49648132,-32.12179596
129,슈퍼마켓,4,골목상권,312761370,175462018,166230651,-137299352,-9231367,-43.89907616,-5.261176809
130,슈퍼마켓,4,관광특구,8637031312,7096360144,4862375789,-1540671168,-2233984355,-17.83797132,-31.48070715
131,슈퍼마켓,4,발달상권,7785409346,7956231283,5601602046,170821937,-2354629237,2.194129164,-29.59478116
132,스포츠클럽,1,관광특구,328094136,394722099,296949667,66627963,-97772432,20.30757508,-24.76994124
133,스포츠클럽,1,발달상권,39864590,24435440,21548472,-15429150,-2886968,-38.70389737,-11.81467573
134,스포츠클럽,2,관광특구,431635943,432780915,374417736,1144972,-58363179,0.265263359,-13.48561754
135,스포츠클럽,2,발달상권,44129598,25426066,13208346,-18703532,-12217720,-42.38319144,-48.05194795
136,스포츠클럽,3,관광특구,372688549,397617534,354259413,24928985,-43358121,6.688959204,-10.90447913
137,스포츠클럽,3,발달상권,37170864,35285153,35379498,-1885711,94345,-5.073088966,0.267378747
138,스포츠클럽,4,관광특구,1139503040,366660597,476840067,-772842443,110179470,-67.82276272,30.04944379
139,스포츠클럽,4,발달상권,125394441,23491987,1415180,-101902454,-22076807,-81.26552755,-93.97590336
140,시계및귀금속,1,골목상권,89473130,67735180,37138504,-21737950,-30596676,-24.29550637,-45.17102634
141,시계및귀금속,1,관광특구,672311481,390888115,255674909,-281423366,-135213206,-41.85907484,-34.59128093
142,시계및귀금속,1,발달상권,561333332,313708881,214504426,-247624451,-99204455,-44.11361964,-31.62309422
143,시계및귀금속,2,골목상권,164567868,6132964,282797783,-158434904,276664819,-96.27329194,4511.111088
144,시계및귀금속,2,관광특구,1086534518,340251683,561221121,-746282835,220969438,-68.6846872,64.94293755
145,시계및귀금속,2,발달상권,874122066,304605247,276281952,-569516819,-28323295,-65.15300793,-9.298360839
146,시계및귀금속,3,골목상권,12265928,11584488,22487535,-681440,10903047,-5.555551932,94.11764249
147,시계및귀금속,3,관광특구,802171560,334558773,419868939,-467612787,85310166,-58.29336395,25.49930622
148,시계및귀금속,3,발달상권,775094676,313357340,395452227,-461737336,82094887,-59.57173366,26.1984886
149,시계및귀금속,4,골목상권,129968786,50426593,202183380,-79542193,151756787,-61.20099714,300.9459453
150,시계및귀금속,4,관광특구,804383942,385565754,310723693,-418818188,-74842061,-52.06695039,-19.41097212
151,시계및귀금속,4,발달상권,583644285,314676385,103331536,-268967900,-211344849,-46.0842172,-67.1626023
152,신발,1,골목상권,252062736,174472426,3991473422,-77590310,3817000996,-30.78214227,2187.738821
153,신발,1,관광특구,1006703292,804336037,4994746091,-202367255,4190410054,-20.10197608,520.9775344
154,신발,1,발달상권,273617626,235565263,124302306,-38052363,-111262957,-13.90713148,-47.23232771
155,신발,1,전통시장,165165726,167164453,723628685,1998727,556464232,1.210134238,332.8843076
156,신발,2,골목상권,451790222,294951177,6334916294,-156839045,6039965117,-34.71501537,2047.784714
157,신발,2,관광특구,1478211440,995913253,7215942550,-482298187,6220029297,-32.6271448,624.5553293
158,신발,2,발달상권,361787333,283605566,53958836,-78181767,-229646730,-21.60986852,-80.97398554
159,신발,2,전통시장,221996402,119110734,622026312,-102885668,502915578,-46.34564663,422.2252362
160,신발,3,골목상권,350662234,209045659,5459190276,-141616575,5250144617,-40.38546535,2511.482248
161,신발,3,관광특구,978916151,1044676093,6033222552,65759942,4988546459,6.717627647,477.5208787
162,신발,3,발달상권,279718859,253949186,31767176,-25769673,-222182010,-9.21270489,-87.49073525
163,신발,3,전통시장,149426845,400726003,370654718,251299158,-30071285,168.1753757,-7.504201069
164,신발,4,골목상권,4153461177,6871412602,6993627842,2717951425,122215240,65.43822872,1.7786043
165,신발,4,관광특구,5138831480,7834682164,7585254864,2695850684,-249427300,52.46038315,-3.183630105
166,신발,4,발달상권,383297600,288651883,84816613,-94645717,-203835270,-24.69248881,-70.61629666
167,신발,4,전통시장,141797989,350086433,316416506,208288444,-33669927,146.8909718,-9.617604062
168,안경,1,골목상권,50492125,33865087,35077665,-16627038,1212578,-32.92996284,3.580613863
169,안경,1,관광특구,396205365,338104638,102444901,-58100727,-235659737,-14.66429588,-69.70023789
170,안경,1,발달상권,67476313,64389049,635438,-3087264,-63753611,-4.575330012,-99.01312722
171,안경,2,골목상권,103556860,75250165,49950166,-28306695,-25299999,-27.33444699,-33.62118741
172,안경,2,관광특구,503867949,513665189,142129263,9797240,-371535926,1.944406271,-72.33036888
173,안경,3,골목상권,80582923,61127989,26495829,-19454934,-34632160,-24.14275044,-56.65516004
174,안경,3,관광특구,478949279,476436265,117121498,-2513014,-359314767,-0.524693138,-75.41717401
175,안경,3,발달상권,80871522,62027671,2368450,-18843851,-59659221,-23.30097237,-96.18162352
176,안경,4,골목상권,61660939,61680013,62807509,19074,1127496,0.030933684,1.827976268
177,안경,4,관광특구,418361387,139063293,129812744,-279298094,-9250549,-66.76000766,-6.652042247
178,안경,4,발달상권,79199538,12866894,7817812,-66332644,-5049082,-83.75382695,-39.24087662
179,애완동물,4,관광특구,19330582,29448602,12823693,10118020,-16624909,52.34203502,-56.45398379
180,양식음식점,1,골목상권,11179009693,9827330618,9223535288,-1351679075,-603795330,-12.09122375,-6.144042095
181,양식음식점,1,관광특구,26162659678,20131379312,16229891061,-6031280366,-3901488251,-23.05300929,-19.38013382
182,양식음식점,1,발달상권,12120744846,9259327399,7687928644,-2861417447,-1571398755,-23.60760402,-16.97098166
183,양식음식점,1,전통시장,1494078917,750878442,446693376,-743200475,-304185066,-49.7430535,-40.51056056
184,양식음식점,2,골목상권,12429448451,9581193478,5248386874,-2848254973,-4332806604,-22.91537701,-45.22199258
185,양식음식점,2,관광특구,29121168283,18342929279,10198404320,-10778239004,-8144524959,-37.0116985,-44.4014412
186,양식음식점,2,발달상권,13103623170,8253340417,4097226762,-4850282753,-4156113655,-37.0148217,-50.35674581
187,양식음식점,2,전통시장,1666510282,701738716,272375078,-964771566,-429363638,-57.89172599,-61.18568467
188,양식음식점,3,골목상권,12183210149,10247293789,6073716580,-1935916360,-4173577209,-15.89003503,-40.72857961
189,양식음식점,3,관광특구,27858432190,21170685504,11745986419,-6687746686,-9424699085,-24.0061847,-44.517685
190,양식음식점,3,발달상권,11645021424,9706069612,4813997314,-1938951812,-4892072298,-16.6504787,-50.4021967
191,양식음식점,3,전통시장,1579503722,712897107,289594118,-866606615,-423302989,-54.86575327,-59.37785199
192,양식음식점,4,골목상권,12651146500,13213597072,6412845747,562450572,-6800751325,4.445846643,-51.46782733
193,양식음식점,4,관광특구,29135031169,24130670686,11249268085,-5004360483,-12881402601,-17.17643772,-53.38186729
194,양식음식점,4,발달상권,12415861371,11791313736,4523115924,-624547635,-7268197812,-5.03024008,-61.6402716
195,양식음식점,4,전통시장,1420951075,702803173,308522633,-718147902,-394280540,-50.53994572,-56.1011326
196,여관,1,관광특구,517528348,447988416,314037887,-69539932,-133950529,-13.43693196,-29.90044479
197,여관,1,발달상권,561897210,490893993,361272811,-71003217,-129621182,-12.63633557,-26.40512694
198,여관,2,관광특구,524297370,373895043,169298898,-150402327,-204596145,-28.6864546,-54.72020794
199,여관,2,발달상권,544780984,432571678,174505280,-112209306,-258066398,-20.59714074,-59.65864413
200,여관,3,관광특구,526993613,360509714,141383952,-166483899,-219125762,-31.59125555,-60.78220738
201,여관,3,발달상권,559743443,480558619,157491495,-79184824,-323067124,-14.14662824,-67.22741227
202,여관,4,관광특구,492872146,379800715,117664006,-113071431,-262136709,-22.94133112,-69.01954068
203,여관,4,발달상권,528217908,464001785,123016019,-64216123,-340985766,-12.15712721,-73.48802893
204,예술학원,1,관광특구,100550359,285389033,34276044,184838674,-251112989,183.8269657,-87.98971227
205,예술학원,2,관광특구,192078301,345130549,40244509,153052248,-304886040,79.68221668,-88.33933736
206,예술학원,3,관광특구,132073202,204974154,212886634,72900952,7912480,55.19738364,3.860233032
207,예술학원,4,관광특구,866892779,197607363,280347347,-669285416,82739984,-77.20509759,41.87090134
208,운동/경기용품,1,골목상권,1275406935,1177108161,1066744538,-98298774,-110363623,-7.707247883,-9.375826849
209,운동/경기용품,1,관광특구,2783136779,2223566566,1791196130,-559570213,-432370436,-20.10573886,-19.44490633
210,운동/경기용품,1,발달상권,307826837,292546763,289657250,-15280074,-2889513,-4.963853753,-0.987709784
211,운동/경기용품,1,전통시장,1132820841,554174386,515161042,-578646455,-39013344,-51.08013854,-7.039903862
212,운동/경기용품,2,골목상권,1681397318,1325957643,974348093,-355439675,-351609550,-21.13954098,-26.51740437
213,운동/경기용품,2,관광특구,3179914092,2314046987,2366030699,-865867105,51983712,-27.22926092,2.246441507
214,운동/경기용품,2,발달상권,338454375,291185938,283058322,-47268437,-8127616,-13.96597015,-2.79121171
215,운동/경기용품,2,전통시장,1228882276,640694758,1059111860,-588187518,418417102,-47.86361798,65.3067778
216,운동/경기용품,3,골목상권,1155484072,1340974920,687122537,185490848,-653852383,16.05308567,-48.75947889
217,운동/경기용품,3,관광특구,3695754758,2401454988,1530924529,-1294299770,-870530459,-35.02125695,-36.250126
218,운동/경기용품,3,발달상권,337652511,294180693,251203,-43471818,-293929490,-12.87472078,-99.91460928
219,운동/경기용품,3,전통시장,2180002342,654482619,791437213,-1525519723,136954594,-69.97789377,20.92562736
220,운동/경기용품,4,골목상권,2548124060,1290848954,1023233194,-1257275106,-267615760,-49.3412046,-20.7317641
221,운동/경기용품,4,관광특구,3576189953,1933082354,2036937436,-1643107599,103855082,-45.94575849,5.372512029
222,운동/경기용품,4,발달상권,321284460,297912453,6908070,-23372007,-291004383,-7.274552588,-97.68117448
223,운동/경기용품,4,전통시장,698239539,307086054,1019494897,-391153485,712408843,-56.01995635,231.9899695
224,육류판매,1,관광특구,516023965,2250562580,3064067008,1734538615,813504428,336.135283,36.14671439
225,육류판매,2,관광특구,1077633538,2359825747,3013887489,1282192209,654061742,118.9822109,27.71652707
226,육류판매,3,관광특구,1145527545,2422975736,2807312981,1277448191,384337245,111.5161479,15.8621995
227,육류판매,4,관광특구,1136944275,2599527203,2825964192,1462582928,226436989,128.6415667,8.710698959
228,의약품,1,관광특구,324536300,340760988,237786080,16224688,-102974908,4.999344603,-30.21910125
229,의약품,1,발달상권,452895152,500274899,442735147,47379747,-57539752,10.46152664,-11.50162683
230,의약품,2,관광특구,338305046,342553923,306632787,4248877,-35921136,1.25593072,-10.48627197
231,의약품,2,발달상권,505272815,497889705,570691416,-7383110,72801711,-1.461212593,14.6220559
232,의약품,3,관광특구,318594833,327722066,272554695,9127233,-55167371,2.864840247,-16.83358453
233,의약품,3,발달상권,487760509,500122651,462122961,12362142,-37999690,2.534469637,-7.598074177
234,의약품,4,관광특구,359313676,243995747,241762698,-115317929,-2233049,-32.09394373,-0.915199969
235,의약품,4,발달상권,539672093,428190681,421388121,-111481412,-6802560,-20.65724973,-1.588675397
236,일반의류,1,골목상권,4601302936,2255147480,3334443099,-2346155456,1079295619,-50.98893702,47.85920338
237,일반의류,1,관광특구,15379100091,13581747891,9823957399,-1797352200,-3757790492,-11.68697901,-27.66794467
238,일반의류,1,발달상권,3439905981,3089847681,2414486430,-350058300,-675361251,-10.1763915,-21.85742861
239,일반의류,1,전통시장,1795335845,1390957196,886010957,-404378649,-504946239,-22.52384422,-36.30206885
240,일반의류,2,골목상권,5664742701,2802135885,4131724987,-2862606816,1329589102,-50.53374826,47.44913011
241,일반의류,2,관광특구,18049045949,17785101276,10023307892,-263944673,-7761793384,-1.462374653,-43.64210956
242,일반의류,2,발달상권,4101837383,3007553826,1782135875,-1094283557,-1225417951,-26.67788737,-40.74467231
243,일반의류,2,전통시장,2035625782,1292117695,976046660,-743508087,-316071035,-36.52479221,-24.46147408
244,일반의류,3,골목상권,4404517099,3039121278,3559820855,-1365395821,520699577,-30.99989829,17.13322798
245,일반의류,3,관광특구,15958281631,14507180023,8825568183,-1451101608,-5681611840,-9.093094367,-39.16413687
246,일반의류,3,발달상권,4962367801,2456457794,1859043702,-2505910007,-597414092,-50.49827235,-24.32014478
247,일반의류,3,전통시장,1762973550,1296036714,644338219,-466936836,-651698495,-26.48575391,-50.28395322
248,일반의류,4,골목상권,4420411828,4453057756,3939689214,32645928,-513368542,0.738526845,-11.52845012
249,일반의류,4,관광특구,19445580021,18771524012,11332489238,-674056009,-7439034774,-3.466371321,-39.62935971
250,일반의류,4,발달상권,6058844115,4944626933,2807952279,-1114217182,-2136674654,-18.38992984,-43.21204983
251,일반의류,4,전통시장,1840508949,2849523046,1118154957,1009014097,-1731368089,54.82255859,-60.75992582
252,일반의원,1,관광특구,504668009,421950749,436258519,-82717260,14307770,-16.39043064,3.390862567
253,일반의원,1,발달상권,273359593,237688128,202529978,-35671465,-35158150,-13.04928231,-14.7917148
254,일반의원,2,관광특구,439389574,503351249,420607663,63961675,-82743586,14.55693962,-16.43853793
255,일반의원,2,발달상권,244205185,251060134,176027187,6854949,-75032947,2.807044822,-29.88644426
256,일반의원,3,관광특구,435994128,508574427,465610439,72580299,-42963988,16.64708177,-8.447925361
257,일반의원,3,발달상권,232549944,285363571,192663972,52813627,-92699599,22.71065995,-32.48473471
258,일반의원,4,관광특구,445328368,609129437,520299322,163801069,-88830115,36.78208728,-14.58312628
259,일반의원,4,발달상권,236541918,281338813,211211656,44796895,-70127157,18.93824798,-24.92622907
260,일식음식점,1,골목상권,928922238,508029835,438895283,-420892403,-69134552,-45.30975638,-13.60836456
261,일식음식점,1,관광특구,2524169218,1486075524,916930454,-1038093694,-569145070,-41.12615298,-38.2985293
262,일식음식점,1,발달상권,858852356,293666815,89665939,-565185541,-204000876,-65.80706649,-69.46677853
263,일식음식점,2,골목상권,871128184,468904058,305298902,-402224126,-163605156,-46.17278299,-34.89096612
264,일식음식점,2,관광특구,2434437046,1420941307,569624654,-1013495739,-851316653,-41.63162653,-59.91216166
265,일식음식점,2,발달상권,811389374,285562515,21167804,-525826859,-264394711,-64.80573641,-92.58733101
266,일식음식점,3,골목상권,1035707298,362492833,333783736,-673214465,-28709097,-65.00045585,-7.919907481
267,일식음식점,3,관광특구,2454652723,1438563010,627458072,-1016089713,-811104938,-41.39443855,-56.38299695
268,일식음식점,3,발달상권,765456703,259081202,17393456,-506375501,-241687746,-66.15338255,-93.28648475
269,일식음식점,4,골목상권,2441303047,552568989,376934951,-1888734058,-175634038,-77.36581742,-31.78499726
270,일식음식점,4,관광특구,5179583052,1239905996,687319258,-3939677056,-552586738,-76.06166397,-44.56682521
271,일식음식점,4,발달상권,1394822209,191068729,34089626,-1203753480,-156979103,-86.30157107,-82.15844834
272,자동차미용,1,관광특구,19324573,19173444,24027392,-151129,4853948,-0.78205609,25.31599435
273,자동차미용,2,관광특구,16085407,17049398,25830693,963991,8781295,5.992953738,51.50501502
274,자동차미용,3,관광특구,18185566,18738656,20370893,553090,1632237,3.041368083,8.710533989
275,자동차미용,4,관광특구,19252707,22152813,38981251,2900106,16828438,15.06336745,75.96524198
276,전자상거래업,1,관광특구,13950236,905045134,327161419,891094898,-577883715,6387.668983,-63.85136976
277,전자상거래업,2,관광특구,149524523,854375457,420667154,704850934,-433708303,471.3948721,-50.76319778
278,전자상거래업,3,관광특구,21474695,573343862,454820783,551869167,-118523079,2569.857998,-20.67225043
279,전자상거래업,4,관광특구,215815640,552435513,467686181,336619873,-84749332,155.9756619,-15.34103619
280,제과점,1,관광특구,1719835099,1400329302,883691289,-319505797,-516638013,-18.57769952,-36.89403716
281,제과점,1,발달상권,1519028748,1278741038,876981998,-240287710,-401759040,-15.81850971,-31.41832694
282,제과점,2,관광특구,1727795764,1218412847,542275022,-509382917,-676137825,-29.48166257,-55.49332697
283,제과점,2,발달상권,1417675507,1072983639,468845298,-344691868,-604138341,-24.31387622,-56.30452498
284,제과점,3,관광특구,1554451792,1304422542,550662843,-250029250,-753759699,-16.08472204,-57.78493354
285,제과점,3,발달상권,1303311515,1140239027,466620201,-163072488,-673618826,-12.51216506,-59.07698386
286,제과점,4,관광특구,1672072471,1230270736,611367990,-441801735,-618902746,-26.42240349,-50.30622349
287,제과점,4,발달상권,1408584249,1049229960,486801554,-359354289,-562428406,-25.51173558,-53.60392168
288,조명용품,1,골목상권,22022209,27432755,18853624,5410546,-8579131,24.56858892,-31.27331178
289,조명용품,1,관광특구,22022209,27432755,18853624,5410546,-8579131,24.56858892,-31.27331178
290,조명용품,1,발달상권,5966020,4182952,1209567,-1783068,-2973385,-29.88706039,-71.08341191
291,조명용품,2,골목상권,30779543,28496372,15500969,-2283171,-12995403,-7.417819686,-45.60371054
292,조명용품,2,관광특구,30779543,28496372,15500969,-2283171,-12995403,-7.417819686,-45.60371054
293,조명용품,2,발달상권,6873997,2776870,1658743,-4097127,-1118127,-59.60327012,-40.26573084
294,조명용품,3,골목상권,23529223,37709629,12442178,14180406,-25267451,60.26720899,-67.00530254
295,조명용품,3,관광특구,23529223,37709629,12442178,14180406,-25267451,60.26720899,-67.00530254
296,조명용품,3,발달상권,3351174,3220432,295173,-130742,-2925259,-3.901379039,-90.83436632
297,조명용품,4,골목상권,32131960,33365930,16321450,1233970,-17044480,3.840319732,-51.08348546
298,조명용품,4,관광특구,32131960,33365930,16321450,1233970,-17044480,3.840319732,-51.08348546
299,조명용품,4,발달상권,4838678,3120169,1715692,-1718509,-1404477,-35.51608518,-45.01285027
300,중식음식점,1,골목상권,735295497,849715002,530434575,114419505,-319280427,15.56102349,-37.57500177
301,중식음식점,1,관광특구,2097752566,2103779249,919304151,6026683,-1184475098,0.287292367,-56.30225218
302,중식음식점,1,발달상권,1171651338,1072094126,120975845,-99557212,-951118281,-8.497170512,-88.71593062
303,중식음식점,2,골목상권,800211150,781959510,502513041,-18251640,-279446469,-2.280852997,-35.73669294
304,중식음식점,2,관광특구,2232753744,1901817307,775506635,-330936437,-1126310672,-14.82189596,-59.22286372
305,중식음식점,2,발달상권,1233835326,987369421,73601500,-246465905,-913767921,-19.97559154,-92.54569785
306,중식음식점,3,골목상권,845982540,1037458641,550365265,191476101,-487093376,22.63357598,-46.95063078
307,중식음식점,3,관광특구,2053549213,1934173562,790498332,-119375651,-1143675230,-5.813138066,-59.12991742
308,중식음식점,3,발달상권,1042411573,920867422,51065778,-121544151,-869801644,-11.65990038,-94.45460044
309,중식음식점,4,골목상권,936623291,624089222,442573842,-312534069,-181515380,-33.36817181,-29.08484454
310,중식음식점,4,관광특구,2395294477,1227586271,698763765,-1167708206,-528822506,-48.7500897,-43.0782356
311,중식음식점,4,발달상권,1230286217,235076449,52368563,-995209768,-182707886,-80.89253982,-77.72275223
312,철물점,1,발달상권,26392819,24547542,27884727,-1845277,3337185,-6.991587371,13.59478273
313,철물점,2,발달상권,40103679,32824646,29487461,-7279033,-3337185,-18.15053676,-10.16670523
314,철물점,3,발달상권,23714936,32053778,31833656,8338842,-220122,35.16282734,-0.686727162
315,철물점,4,발달상권,69714507,38485486,44085768,-31229021,5600282,-44.79558465,14.5516728
316,치과의원,1,골목상권,18429016,22214966,47175342,3785950,24960376,20.54341914,112.3583804
317,치과의원,1,관광특구,777014630,553392401,482340371,-223622229,-71052030,-28.77966777,-12.83935773
318,치과의원,1,발달상권,542391620,368455701,273856764,-173935919,-94598937,-32.06832712,-25.67443976
319,치과의원,2,골목상권,34449271,44402530,49027604,9953259,4625074,28.8925098,10.4162398
320,치과의원,2,관광특구,530714710,582348841,352640493,51634131,-229708348,9.729168992,-39.44514556
321,치과의원,2,발달상권,322388936,322495997,188397626,107061,-134098371,0.033208646,-41.58140636
322,치과의원,3,골목상권,18092854,16868273,85567408,-1224581,68699135,-6.768313059,407.2683374
323,치과의원,3,관광특구,593030248,554827891,423070387,-38202357,-131757504,-6.441890128,-23.74745505
324,치과의원,3,발달상권,401301047,276501813,182028612,-124799234,-94473201,-31.09865647,-34.16729893
325,치과의원,4,골목상권,17108818,29763062,96952984,12654244,67189922,73.96328607,225.7493601
326,치과의원,4,관광특구,506465268,397523332,475370135,-108941936,77846803,-21.51024816,19.58295193
327,치과의원,4,발달상권,369197836,188947498,201781339,-180250338,12833841,-48.82215453,6.79227888
328,치킨전문점,1,관광특구,332649720,80101944,64478561,-252547776,-15623383,-75.92003264,-19.50437433
329,치킨전문점,1,발달상권,212605392,68244784,64478561,-144360608,-3766223,-67.90072756,-5.518697224
330,치킨전문점,2,관광특구,339783590,61383272,55518791,-278400318,-5864481,-81.93459784,-9.553874873
331,치킨전문점,2,발달상권,236175854,61383272,55518791,-174792582,-5864481,-74.00950565,-9.553874873
332,치킨전문점,3,관광특구,293924818,53300587,58069837,-240624231,4769250,-81.86591137,8.947837666
333,치킨전문점,3,발달상권,189130271,53300587,58069837,-135829684,4769250,-71.81805603,8.947837666
334,치킨전문점,4,관광특구,289679541,59737800,29166481,-229941741,-30571319,-79.37797064,-51.17583674
335,치킨전문점,4,발달상권,224789626,59737800,29166481,-165051826,-30571319,-73.42501918,-51.17583674
336,커피-음료,1,골목상권,2508880875,2339421645,2592197573,-169459230,252775928,-6.754375295,10.80506067
337,커피-음료,1,관광특구,6591950631,4861904850,5853662391,-1730045781,991757541,-26.24482309,20.39853867
338,커피-음료,1,발달상권,2696905219,933330321,1096783634,-1763574898,163453313,-65.39254274,17.51291149
339,커피-음료,1,전통시장,274493739,466318606,843000000,191824867,376681394,69.88314841,80.77768915
340,커피-음료,2,골목상권,3071650324,2353323172,2088364714,-718327152,-264958458,-23.38570723,-11.2589066
341,커피-음료,2,관광특구,7667700706,4724007693,4793409993,-2943693013,69402300,-38.39081787,1.469140283
342,커피-음료,2,발달상권,3037723811,841922970,621856845,-2195800841,-220066125,-72.28441352,-26.13851063
343,커피-음료,2,전통시장,341113512,603273977,851573682,262160465,248299705,76.85431851,41.15869646
344,커피-음료,3,골목상권,2839169813,2324430792,2012136277,-514739021,-312294515,-18.12991314,-13.43531139
345,커피-음료,3,관광특구,7560886244,5017709156,4483673900,-2543177088,-534035256,-33.63596549,-10.64300938
346,커피-음료,3,발달상권,3351065651,900103150,540472214,-2450962501,-359630936,-73.13979361,-39.95441367
347,커피-음료,3,전통시장,321678657,363109163,915765346,41430506,552656183,12.87946996,152.2011118
348,커피-음료,4,골목상권,3005477872,2746392572,1556337683,-259085300,-1190054889,-8.620436118,-43.33156524
349,커피-음료,4,관광특구,8059959709,6542256953,3896816097,-1517702756,-2645440856,-18.83015314,-40.43621146
350,커피-음료,4,발달상권,3677703128,1314344515,507288889,-2363358613,-807055626,-64.26181045,-61.40365915
351,커피-음료,4,전통시장,290607393,843000000,850536239,552392607,7536239,190.0820902,0.893978529
352,패스트푸드점,1,골목상권,817060624,790312466,486741270,-26748158,-303571196,-3.273705428,-38.41154089
353,패스트푸드점,1,관광특구,3743531030,2929482809,1699187873,-814048221,-1230294936,-21.74546476,-41.99700139
354,패스트푸드점,1,발달상권,2130710806,1035380044,383588010,-1095330762,-651792034,-51.40682438,-62.95196028
355,패스트푸드점,1,전통시장,492681895,866591066,651786419,373909171,-214804647,75.89261444,-24.78731381
356,패스트푸드점,2,골목상권,1006928366,731046291,139066469,-275882075,-591979822,-27.39838149,-80.97706387
357,패스트푸드점,2,관광특구,3906791566,2755963970,1007079564,-1150827596,-1748884406,-29.4571025,-63.4581738
358,패스트푸드점,2,발달상권,2130149512,1028881358,226703271,-1101268154,-802178087,-51.6991013,-77.96604349
359,패스트푸드점,2,전통시장,507827185,753631521,567544051,245804336,-186087470,48.40314644,-24.69210281
360,패스트푸드점,3,골목상권,819174036,733019356,127487495,-86154680,-605531861,-10.51726205,-82.60789515
361,패스트푸드점,3,관광특구,3681255402,2713754448,874773016,-967500954,-1838981432,-26.28182096,-67.76521116
362,패스트푸드점,3,발달상권,1882219615,953181936,208137327,-929037679,-745044609,-49.35862274,-78.1639455
363,패스트푸드점,3,전통시장,609948410,781781921,542112828,171833511,-239669093,28.17181063,-30.65677097
364,패스트푸드점,4,골목상권,977615496,726448427,92443103,-251167069,-634005324,-25.69180522,-87.27465026
365,패스트푸드점,4,관광특구,3866472486,2297177796,809537047,-1569294690,-1487640749,-40.58724576,-64.75949539
366,패스트푸드점,4,발달상권,1993182916,551630775,210549980,-1441552141,-341080795,-72.32412687,-61.83135722
367,패스트푸드점,4,전통시장,612476982,813792288,489568290,201315306,-324223998,32.86904029,-39.84112442
368,편의점,1,골목상권,1369528845,1278626264,1122315165,-90902581,-156311099,-6.637507588,-12.22492478
369,편의점,1,관광특구,7687978928,6438935853,6392433452,-1249043075,-46502401,-16.24670263,-0.72220631
370,편의점,1,발달상권,3238227506,3024593222,2668175050,-213634284,-356418172,-6.597259878,-11.78400353
371,편의점,2,골목상권,1711054766,1416441783,776702990,-294612983,-639738793,-17.21820884,-45.16520203
372,편의점,2,관광특구,8603540019,6946543748,4944770686,-1656996271,-2001773062,-19.25947072,-28.81682078
373,편의점,2,발달상권,3525249940,3262607818,1723391841,-262642122,-1539215977,-7.450312076,-47.17747467
374,편의점,3,골목상권,1757782531,1588037643,840890438,-169744888,-747147205,-9.656762711,-47.04845684
375,편의점,3,관광특구,8508783593,7491748293,5318844986,-1017035300,-2172903307,-11.95276962,-29.00395505
376,편의점,3,발달상권,3700984460,3553463531,1962210895,-147520929,-1591252636,-3.985991581,-44.78032832
377,편의점,4,골목상권,1558862445,1577000525,841821665,18138080,-735178860,1.163545896,-46.61880883
378,편의점,4,관광특구,7621733575,8195850067,5216940640,574116492,-2978909427,7.532623469,-36.34655835
379,편의점,4,발달상권,3145192400,3548877922,1928160678,403685522,-1620717244,12.83500246,-45.66844168
380,피부관리실,1,골목상권,74975766,56238865,38191597,-18736901,-18047268,-24.99060963,-32.09038447
381,피부관리실,1,관광특구,153443117,24314089,23243179,-129129028,-1070910,-84.15433062,-4.404483343
382,피부관리실,2,골목상권,86348267,69981434,41307225,-16366833,-28674209,-18.95444294,-40.9740232
383,피부관리실,2,관광특구,130280969,32259116,15287137,-98021853,-16971979,-75.23881174,-52.61141998
384,피부관리실,3,골목상권,68314934,66060663,38479070,-2254271,-27581593,-3.299821676,-41.75191672
385,피부관리실,3,관광특구,100874749,29759435,11416483,-71115314,-18342952,-70.49862796,-61.63743364
386,피부관리실,4,골목상권,75783944,66264410,32914328,-9519534,-33350082,-12.56141274,-50.32879943
387,피부관리실,4,관광특구,55734470,21877704,9819777,-33856766,-12057927,-60.74654698,-55.11513914
388,한식음식점,1,골목상권,5463348716,6277584583,6430771137,814235867,153186554,14.90360417,2.440214894
389,한식음식점,1,관광특구,12634410281,12683249362,9916367907,48839081,-2766881455,0.386556079,-21.81524132
390,한식음식점,1,발달상권,6531717796,6602130745,4230377261,70412949,-2371753484,1.078015787,-35.92406112
391,한식음식점,1,전통시장,750625222,941360117,330148381,190734895,-611211736,25.4101367,-64.92857781
392,한식음식점,2,골목상권,6250525025,5088181913,4748524982,-1162343112,-339656931,-18.59592766,-6.675408561
393,한식음식점,2,관광특구,14691883934,11463860421,6068085448,-3228023513,-5395774973,-21.97147437,-47.067696
394,한식음식점,2,발달상권,7356074813,6047119126,2023623558,-1308955687,-4023495568,-17.7942139,-66.5357418
395,한식음식점,2,전통시장,878479549,862462437,275280763,-16017112,-587181674,-1.823276594,-68.08199973
396,한식음식점,3,골목상권,6242902855,6249118886,4710500959,6216031,-1538617927,0.099569562,-24.62135791
397,한식음식점,3,관광특구,14430709367,12342306693,6030840095,-2088402674,-6311466598,-14.47193358,-51.13684788
398,한식음식점,3,발달상권,7128791864,6416677429,1905235230,-712114435,-4511442199,-9.989272356,-70.30807219
399,한식음식점,3,전통시장,968137030,965106338,342725002,-3030692,-622381336,-0.313043702,-64.48836895
400,한식음식점,4,골목상권,6262507136,7704468770,3350740680,1441961634,-4353728090,23.02530924,-56.50912762
401,한식음식점,4,관광특구,15515147081,13591538858,5976638807,-1923608223,-7614900051,-12.39825967,-56.02676879
402,한식음식점,4,발달상권,7825331585,6310015203,2060286121,-1515316382,-4249729082,-19.36424502,-67.34895155
403,한식음식점,4,전통시장,889652169,490012149,334455009,-399640020,-155557140,-44.92092909,-31.74556801
404,한의원,1,관광특구,153013177,169443899,58265516,16430722,-111178383,10.73810918,-65.61368315
405,한의원,1,발달상권,77079900,107036818,82800673,29956918,-24236145,38.86475981,-22.64281156
406,한의원,2,관광특구,203604110,160160073,29510983,-43444037,-130649090,-21.33750493,-81.57406996
407,한의원,2,발달상권,87846367,89025471,74683348,1179104,-14342123,1.342234221,-16.11013437
408,한의원,3,관광특구,190956675,152409699,49552605,-38546976,-102857094,-20.18624172,-67.48723649
409,한의원,3,발달상권,90661653,116476365,78056061,25814712,-38420304,28.47368336,-32.98549367
410,한의원,4,관광특구,170074302,77395387,63214041,-92678915,-14181346,-54.49319145,-18.32324451
411,한의원,4,발달상권,79250423,81480756,60464590,2230333,-21016166,2.814285294,-25.79279701
412,핸드폰,1,발달상권,155112737,17657510,138633785,-137455227,120976275,-88.61633781,685.1264703
413,핸드폰,2,발달상권,325324018,152412281,16433284,-172911737,-135978997,-53.15062136,-89.21787412
414,핸드폰,3,발달상권,182929911,136237686,99905893,-46692225,-36331793,-25.52465299,-26.66794634
415,핸드폰,4,발달상권,177014763,10985444,10523600,-166029319,-461844,-93.79405208,-4.204145049
416,호프-간이주점,1,골목상권,3643498565,2739478643,4152308983,-904019922,1412830340,-24.81186436,51.57296421
417,호프-간이주점,1,관광특구,10619989988,8029110117,5785496574,-2590879871,-2243613543,-24.39625531,-27.94348951
418,호프-간이주점,1,발달상권,7724426346,6487499983,4381155702,-1236926363,-2106344281,-16.01318088,-32.46773467
419,호프-간이주점,2,골목상권,4126222772,2923750150,2053609657,-1202472622,-870140493,-29.14221283,-29.76110982
420,호프-간이주점,2,관광특구,11526701629,7622654362,2939663300,-3904047267,-4682991062,-33.86959594,-61.4351752
421,호프-간이주점,2,발달상권,9252111926,6248758050,2110666918,-3003353876,-4138091132,-32.46127911,-66.22261734
422,호프-간이주점,3,골목상권,4527477050,3334472261,1682664713,-1193004789,-1651807548,-26.35032217,-49.53730062
423,호프-간이주점,3,관광특구,10626126753,7389906916,2478665642,-3236219837,-4911241274,-30.45530994,-66.45877045
424,호프-간이주점,3,발달상권,9235111329,6289109600,1943603959,-2946001729,-4345505641,-31.90001316,-69.09572129
425,호프-간이주점,3,전통시장,231068587,103312163,1361825,-127756424,-101950338,-55.28939509,-98.68183478
426,호프-간이주점,4,골목상권,5926427873,5465133527,1705780128,-461294346,-3759353399,-7.783682783,-68.78795148
427,호프-간이주점,4,관광특구,20416606270,7940239976,2524276084,-12476366294,-5415963892,-61.10891364,-68.20907061
428,호프-간이주점,4,발달상권,16419128562,6037205333,1820701530,-10381923229,-4216503803,-63.23065923,-69.84198102
429,화장품,1,골목상권,122092797,150656183,61163210,28563386,-89492973,23.39481665,-59.40212424
430,화장품,1,관광특구,6749380599,6762855886,3158858963,13475287,-3603996923,0.199652202,-53.29105017
431,화장품,1,발달상권,3684524644,3338649993,798338667,-345874651,-2540311326,-9.387225882,-76.08797961
432,화장품,2,골목상권,203987991,215629872,193667824,11641881,-21962048,5.707140378,-10.18506749
433,화장품,2,관광특구,6975214854,6279366559,3147039541,-695848295,-3132327018,-9.976012346,-49.88285026
434,화장품,2,발달상권,3305936258,2979161847,646440054,-326774411,-2332721793,-9.884474034,-78.30127777
435,화장품,3,골목상권,183928778,176914688,155675628,-7014090,-21239060,-3.813481542,-12.00525532
436,화장품,3,관광특구,6949454083,6308956158,3359623072,-640497925,-2949333086,-9.216521432,-46.74835285
437,화장품,3,발달상권,3263689805,3163279522,357191673,-100410283,-2806087849,-3.076587819,-88.70818495
438,화장품,4,골목상권,186925618,68634565,67287743,-118291053,-1346822,-63.28241911,-1.962308641
439,화장품,4,관광특구,10323632597,4356962179,3318153081,-5966670418,-1038809098,-57.79622979,-23.84250896
440,화장품,4,발달상권,6611069022,1030268411,320696558,-5580800611,-709571853,-84.41600885,-68.87252345
441,화초,1,골목상권,70416839,20428261,21875210,-49988578,1446949,-70.98952283,7.083074766
442,화초,1,관광특구,156562485,135506913,107412192,-21055572,-28094721,-13.44867003,-20.73305367
443,화초,1,발달상권,72355829,77239125,44146013,4883296,-33093112,6.749001521,-42.84501151
444,화초,2,골목상권,296066944,57733837,37596194,-238333107,-20137643,-80.49973556,-34.8801397
445,화초,2,관광특구,366979260,149502787,130056197,-217476473,-19446590,-59.26124354,-13.00751002
446,화초,2,발달상권,90835771,82935281,49201768,-7900490,-33733513,-8.697553742,-40.67450257
447,화초,3,골목상권,137008774,88422270,31518241,-48586504,-56904029,-35.46233032,-64.35486105
448,화초,3,관광특구,203818811,130906166,74888705,-72912645,-56017461,-35.7732658,-42.79207215
449,화초,3,발달상권,59931513,63985968,25394659,4054455,-38591309,6.765147077,-60.31214375
450,화초,4,골목상권,121222651,32097646,23116509,-89125005,-8981137,-73.52174224,-27.98067185
451,화초,4,관광특구,187898257,146360995,90018303,-41537262,-56342692,-22.1062519,-38.49570167
452,화초,4,발달상권,77441648,72693398,35774533,-4748250,-36918865,-6.131390696,-50.78709486
